"aa" = (/obj/structure/torchwall{dir = 4; icon_state = "torchwall0"},/turf/simulated/open,/area/space)
"ab" = (/turf/simulated/open,/area/space)
"ac" = (/obj/structure/torchwall{dir = 8},/turf/simulated/open,/area/space)
"ad" = (/turf/simulated/floor/tiled/ramp{dir = 1},/area/space)
"ae" = (/obj/structure/sign/kitchen,/turf/simulated/mineral,/area/space)
"af" = (/obj/effect/landmark/map_data{height = 2},/turf/simulated/mineral,/area/space)
"ag" = (/obj/structure/sign/neon/armory,/turf/simulated/mineral,/area/space)
"ah" = (/obj/structure/sign/redcross,/turf/simulated/mineral,/area/space)
"ai" = (/obj/structure/torchwall{dir = 4; icon_state = "torchwall0"},/turf/simulated/floor/holofloor/tiled,/area/space)
"aj" = (/turf/simulated/floor/holofloor/tiled,/area/space)
"ak" = (/obj/structure/torchwall{dir = 8},/turf/simulated/floor/holofloor/tiled,/area/space)
"al" = (/turf/simulated/floor/dirty/indestructable,/area/space)
"am" = (/turf/simulated/floor/trench,/area/space)
"an" = (/turf/simulated/floor/trenches,/area/space)
"ao" = (/obj/structure/dirt_wall,/turf/simulated/floor/dirty/indestructable,/area/space)
"ap" = (/obj/structure/barbwire,/turf/simulated/floor/dirty/indestructable,/area/space)
"aq" = (/obj/structure/defensive_barrier,/turf/simulated/floor/dirty/indestructable,/area/space)
"ar" = (/obj/structure/dirt_wall,/obj/structure/dirt_wall,/turf/simulated/floor/dirty/indestructable,/area/space)
"as" = (/obj/structure/defensive_barrier,/turf/simulated/floor/holofloor/tiled,/area/space)
"at" = (/obj/structure/torchwall{dir = 8; icon_state = "torchwall0"},/turf/simulated/floor/trench,/area/space)
"au" = (/obj/structure/poster/blue,/turf/simulated/wall/concrete/strong,/area/space)
"av" = (/obj/structure/torchwall{dir = 4; icon_state = "torchwall0"},/turf/simulated/floor/trench,/area/space)
"aw" = (/obj/structure/banner/blue,/turf/simulated/wall/concrete/strong,/area/space)
"ax" = (/obj/structure/barbwire,/obj/structure/barbwire,/turf/simulated/floor/dirty/indestructable,/area/space)
"ay" = (/obj/structure/sign/warning/detailed,/turf/simulated/wall/concrete/strong,/area/space)
"az" = (/obj/structure/destruction_computer/blue,/turf/simulated/floor/dirty/indestructable,/area/space)
"aA" = (/obj/structure/bed,/turf/simulated/floor/trench,/area/space)
"aB" = (/obj/structure/torchwall{dir = 8; icon_state = "torchwall0"},/turf/simulated/floor/dirty/indestructable,/area/space)
"aC" = (/obj/structure/torchwall{dir = 4; icon_state = "torchwall0"},/turf/simulated/floor/dirty/indestructable,/area/space)
"aD" = (/obj/structure/bed/chair{dir = 4; icon_state = "chair_preview"},/turf/simulated/floor/trench,/area/space)
"aE" = (/obj/structure/bed/chair{dir = 8; icon_state = "chair_preview"},/turf/simulated/floor/trench,/area/space)
"aF" = (/obj/structure/defensive_barrier{dir = 8},/turf/simulated/floor/dirty/indestructable,/area/space)
"aG" = (/obj/structure/defensive_barrier{dir = 4},/turf/simulated/floor/dirty/indestructable,/area/space)
"aH" = (/obj/structure/landmine,/turf/simulated/floor/dirty/indestructable,/area/space)
"aI" = (/turf/simulated/floor/dirty/tough,/area/space)
"aJ" = (/obj/structure/sign/warning,/turf/simulated/mineral,/area/space)
"aK" = (/turf/simulated/floor/tiled/ramp,/area/space)
"aL" = (/turf/simulated/floor/tiled,/area/space)
"aM" = (/obj/structure/poster/red,/turf/simulated/wall/concrete/strong,/area/space)
"aN" = (/obj/structure/banner/red,/turf/simulated/wall/concrete/strong,/area/space)
"aO" = (/obj/structure/torchwall{dir = 8},/turf/simulated/floor/dirty/tough,/area/space)
"aP" = (/obj/structure/sign/kitchen,/turf/simulated/wall/concrete/strong,/area/space)
"aQ" = (/obj/structure/torchwall{dir = 4; icon_state = "torchwall0"},/turf/simulated/floor/dirty/tough,/area/space)
"aR" = (/obj/structure/sign/redcross,/turf/simulated/wall/concrete/strong,/area/space)
"aS" = (/turf/simulated/floor/tiled/ramp{dir = 4},/area/space)
"aT" = (/turf/simulated/floor/tiled/ramp{dir = 8},/area/space)
"aU" = (/obj/structure/sign/neon/armory,/turf/simulated/wall/concrete/strong,/area/space)
"Ha" = (/turf/simulated/mineral,/area/space)

(1,1,1) = {"
HaHaHaHaHaHaHaHaHaHaHaHaHaHaHaHaHaHaHaHaHaHaHaHaHaHaHaHaHaHaHaHaHaHaHaHaHaHaHaHaHaHaHaHaHaHaHaHaHaHaHaHaHa
HaHaHaHaHaHaHaHaHaHaHaHaHaHaHaHaHaHaHaHaHaHaHaHaHaHaHaHaHaHaHaHaHaHaHaHaHaHaHaHaHaHaHaHaHaHaHaHaHaHaHaHaHa
HaHaHaHaHaHaHaHaHaHaHaHaHaHaHaHaHaHaHaHaHaHaHaHaHaHaHaHaHaHaHaHaHaHaHaHaHaHaHaHaHaHaHaHaHaHaHaHaHaHaHaHaHa
HaHaHaHaHaHaHaHaHaHaHaHaHaHaHaHaHaHaHaHaHaHaHaHaHaHaHaHaHaHaHaHaHaHaHaHaHaHaHaHaHaHaHaHaHaHaHaHaHaHaHaHaHa
HaHaHaHaHaHaHaHaHaHaHaHaHaHaHaHaHaHaHaHaHaHaHaHaHaHaHaHaHaHaHaHaHaHaHaHaHaHaHaHaHaHaHaHaHaHaHaHaHaHaHaHaHa
HaHaHaHaHaHaHaHaHaHaHaHaHaHaHaHaHaHaHaHaHaHaHaHaHaHaHaHaHaHaHaHaHaHaHaHaHaHaHaHaHaHaHaHaHaHaHaHaHaHaHaHaHa
HaHaHaHaHaHaHaHaHaHaHaHaHaHaHaHaHaHaHaHaHaHaHaHaHaHaHaHaHaHaHaHaHaHaHaHaHaHaHaHaHaHaHaHaHaHaHaHaHaHaHaHaHa
HaHaHaHaHaHaHaHaHaHaHaHaHaHaHaHaHaHaHaHaHaHaHaHaHaHaHaHaHaHaHaHaHaHaHaHaHaHaHaHaHaHaHaHaHaHaHaHaHaHaHaHaHa
HaHaHaHaHaHaHaHaHaHaHaHaHaHaHaHaHaHaHaHaHaHaHaHaHaHaHaHaHaHaHaHaHaHaHaHaHaHaHaHaHaHaHaHaHaHaHaHaHaHaHaHaHa
HaHaHaHaHaHaHaHaHaHaHaHaHaHaHaHaHaHaHaHaHaHaHaHaHaHaHaHaHaHaHaHaHaHaHaHaHaHaHaHaHaHaHaHaHaHaHaHaHaHaHaHaHa
HaHaHaHaHaHaHaHaHaHaHaHaHaHaHaHaHaHaHaHaHaHaHaHaHaHaHaHaHaHaHaHaHaHaHaHaHaHaHaHaHaHaHaHaHaHaHaHaHaHaHaHaHa
HaHaHaHaHaHaHaHaHaHaHaHaHaHaHaHaHaHaHaHaHaHaHaHaHaHaHaHaHaHaHaHaHaHaHaHaHaHaHaHaHaHaHaHaHaHaHaHaHaHaHaHaHa
HaHaHaHaHaHaHaHaHaHaHaHaHaHaHaHaHaHaHaHaHaHaHaHaHaHaHaHaHaHaHaHaHaHaHaHaHaHaHaHaHaHaHaHaHaHaHaHaHaHaHaHaHa
HaHaHaHaHaHaHaHaHaHaHaHaHaHaHaHaHaHaHaHaHaHaHaHaHaHaHaHaHaHaHaHaHaHaHaHaHaHaHaHaHaHaHaHaHaHaHaHaHaHaHaHaHa
HaHaHaHaHaHaHaHaHaHaHaHaHaHaHaHaHaHaHaHaHaHaHaHaHaHaHaHaHaHaHaHaHaHaHaHaHaHaHaHaHaHaHaHaHaHaHaHaHaHaHaHaHa
HaHaHaHaHaHaHaHaHaHaHaHaHaHaHaHaHaHaHaHaHaHaHaHaHaHaHaHaHaHaHaHaHaHaHaHaHaHaHaHaHaHaHaHaHaHaHaHaHaHaHaHaHa
HaHaHaHaHaHaHaHaHaHaHaHaHaHaHaHaHaHaHaHaHaHaHaHaHaHaHaHaHaHaHaHaHaHaHaHaHaHaHaHaHaHaHaHaHaHaHaHaHaHaHaHaHa
HaHaHaHaHaHaHaHaHaHaHaHaHaHaHaHaHaHaHaHaHaHaHaHaHaHaHaHaHaHaHaHaHaHaHaHaHaHaHaHaHaHaHaHaHaHaHaHaHaHaHaHaHa
HaHaHaHaHaHaHaHaHaHaHaHaHaHaHaHaHaHaHaHaHaHaHaHaHaHaHaHaHaHaHaHaHaHaHaHaHaHaHaHaHaHaHaHaHaHaHaHaHaHaHaHaHa
HaHaHaHaHaHaHaHaHaHaHaHaHaHaHaHaHaHaHaHaHaHaHaHaHaHaHaHaHaHaHaHaHaHaHaHaHaHaHaHaHaHaHaHaHaHaHaHaHaHaHaHaHa
HaHaHaHaHaHaHaHaHaHaHaHaHaHaHaHaHaHaHaHaHaHaHaHaHaHaHaHaHaHaHaHaHaHaHaHaHaHaHaHaHaHaHaHaHaHaHaHaHaHaHaHaHa
HaHaHaHaHaHaHaHaHaHaHaHaHaHaHaHaHaHaHaHaHaHaHaHaHaHaHaHaHaHaHaHaHaHaHaHaHaHaHaHaHaHaHaHaHaHaHaHaHaHaHaHaHa
HaHaHaHaHaHaHaHaHaHaHaHaHaHaHaHaHaHaHaHaHaHaHaHaHaHaHaHaHaHaHaHaHaHaHaHaHaHaHaHaHaHaHaHaHaHaHaHaHaHaHaHaHa
HaHaHaHaHaHaHaHaHaHaHaHaHaHaHaHaHaHaHaHaHaHaHaHaHaHaHaHaHaHaHaHaHaHaHaHaHaHaHaHaHaHaHaHaHaHaHaHaHaHaHaHaHa
HaHaHaHaHaHaHaHaHaHaHaHaHaHaHaHaHaHaHaHaHaHaHaHaHaHaHaHaHaHaHaHaHaHaHaHaHaHaHaHaHaHaHaHaHaHaHaHaHaHaHaHaHa
HaHaHaHaHaHaHaHaHaHaHaHaHaHaHaHaHaHaHaHaHaHaHaHaHaHaHaHaHaHaHaHaHaHaHaHaHaHaHaHaHaHaHaHaHaHaHaHaHaHaHaHaHa
HaHaHaHaHaHaHaHaHaHaHaHaHaHaHaHaHaHaHaHaHaHaHaHaHaHaHaHaHaHaHaHaHaHaHaHaHaHaHaHaHaHaHaHaHaHaHaHaHaHaHaHaHa
HaHaHaHaHaHaHaHaHaHaHaHaHaHaHaHaHaHaHaHaHaHaHaHaHaHaHaHaHaHaHaHaHaHaHaHaHaHaHaHaHaHaHaHaHaHaHaHaHaHaHaHaHa
HaHaHaHaHaHaHaHaHaHaHaHaHaHaHaHaHaHaHaHaHaHaHaHaHaHaHaHaHaHaHaHaHaHaHaHaHaHaHaHaHaHaHaHaHaHaHaHaHaHaHaHaHa
HaHaHaHaHaHaHaHaHaHaHaHaHaHaHaHaHaHaHaHaHaHaHaHaHaHaHaHaHaHaHaHaHaHaHaHaHaHaHaHaHaHaHaHaHaHaHaHaHaHaHaHaHa
HaHaHaHaHaHaHaHaHaHaHaHaHaHaHaHaHaHaHaHaHaHaHaHaHaHaHaHaHaHaHaHaHaHaHaHaHaHaHaHaHaHaHaHaHaHaHaHaHaHaHaHaHa
HaHaHaHaHaHaHaHaHaHaHaHaHaHaHaHaHaHaHaHaHaHaHaHaHaHaHaHaHaHaHaHaHaHaHaHaHaHaHaHaHaHaHaHaHaHaHaHaHaHaHaHaHa
HaHaHaHaHaHaHaHaHaHaHaHaHaHaHaHaHaHaHaHaHaHaHaHaHaHaHaHaHaHaHaHaHaHaHaHaHaHaHaHaHaHaHaHaHaHaHaHaHaHaHaHaHa
HaHaHaHaHaHaHaHaHaHaHaHaHaHaHaHaHaHaHaHaHaHaHaHaHaHaHaHaHaHaHaHaHaHaHaHaHaHaHaHaHaHaHaHaHaHaHaHaHaHaHaHaHa
HaHaHaHaHaHaHaHaHaHaHaHaHaHaHaHaHaHaHaHaHaHaHaHaHaHaHaHaHaHaHaHaHaHaHaHaHaHaHaHaHaHaHaHaHaHaHaHaHaHaHaHaHa
HaHaHaHaHaHaHaHaHaHaHaHaHaHaHaHaHaHaHaHaHaHaHaHaHaHaHaHaHaHaHaHaHaHaHaHaHaHaHaHaHaHaHaHaHaHaHaHaHaHaHaHaHa
HaHaHaHaHaHaHaHaHaHaHaHaHaHaHaHaHaHaHaHaHaHaHaHaHaHaHaHaHaHaHaHaHaHaHaHaHaHaHaHaHaHaHaHaHaHaHaHaHaHaHaHaHa
HaHaHaHaHaHaHaHaaaabababacHaHaHaHaHaHaHaHaaaacHaHaaaabacHaHaaaacHaHaHaHaHaHaHaHaaaabababacHaHaHaHaHaHaHaHa
HaHaHaHaHaHaHaHaadadadadadHaHaHaHaHaHaHaaeadadaeagadadadagahadadahHaHaHaHaHaHaHaadadadadadHaHaHaHaHaHaHaHa
HaHaHaHaHaHaHaHaaiajajajakHaHaHaalalalamamananamamanananamamananamamalalalHaHaHaaiajajajakHaHaHaHaHaHaHaHa
HaHaHaHaHaHaHaHaalalalalalHaHaHaalalamamamamamamamamamamamamamamamamamalalalHaalalalalalalHaHaHaHaHaHaHaHa
HaHaHaHaHaHaHaalalalalalalalHaalalalamamamamamamamamamamamamamamamamamalalalalalalalalalalalHaHaHaHaHaHaHa
HaHaHaHaHaHaalalalalalalalalalalalalamamamaoaoaoajajajajajaoaoaoamamamalalalalalalalalalalalHaHaHaHaHaHaHa
HaHaHaHaHaHaalalalalalalalalalalalamamamaoaoapapaqaqaqaqaqapapaoaoamamamalalalalalalalalalalalHaHaHaHaHaHa
HaHaHaHaHaalalalalalalalalalalalamamamamaoapapalalalalalalalapaparamamamamalalalalalalalalalalalHaHaHaHaHa
HaHaHaHaHaalalalalalalalalalalamamamamasaoapalamamamamamamamalapaoasamamamamalalalalalalalalalalHaHaHaHaHa
HaHaHaHaHaamamamajamamamajamamamamamaoalapapamamamatauavamamamapapalaoamamamamamajamamamajamamamHaHaHaHaHa
HaHaHaHaHaamamamasamamamasamamamamasaoalapamamamapamalamapamamamapalaoasamamamamasamamamasamamamHaHaHaHaHa
HaHaHaHaHaaoaoaoalaoaoaoalaoaoaoaoalapalamamamapaoatawavarapamamamalapalaoaoaoaoalaoaoaoalaoaoaoHaHaHaHaHa
HaHaHaHaHaapapapalapapapalapapapapalapalamaxapaoayamazamayaoapaxamalapalapapapapalapapapalapapapHaHaHaHaHa
HaHaHaHaHaamamamajamamamajamamamamalamalamapamamajamamamajamamapamalamalamamamamajamamamajamamamHaHaHaHaHa
HaHaHaHaHaamaoaoasamamamasamamamamaqamaqamaxaxamaoayamayaoamapapamaqamaqamamamamasamamamasaoaoamHaHaHaHaHa
HaHaHaHaHaamapaoalaoamaoalaoamaoaoalaoalamamaxapapapapapapapaxamamalaoalaoaoamaoalaoamaoalaoapamHaHaHaHaHa
HaHaHaHaHaanapapalapanapalapanapapalalalaoamamamajamamamajamamamaoalalalapapanapalapanapalapapanHaHaHaHaHa
HaHaHaHaHaaAamaAalaAamaAalaAamaAaoaBauaCaoaoamamasamamamasamamaoaoaBauaCaoaAamaAalaAamaAalaAamaAHaHaHaHaHa
HaHaHaHaHaaoaoaoalaoaoaoalaoaoaoaoalalalalaoaoaoaoaoaoaoaoaoaoaoalalalalaoaoaoaoalaoaoaoalaoaoaoHaHaHaHaHa
HaHaHaHaHaapapapaqapapapaqapapapapaqaqaqapapapapapapapapapapapapapaqaqaqapapapapaqapapapaqapapapHaHaHaHaHa
HaHaHaHaHaamamamamamamamamamamamamamajamamamamamamamamamamamamamamamajamamamamamamamamamamamamamHaHaHaHaHa
HaHaHaHaHaamamamamamamamamamamamamamajamamamamamamamamamamamamamamamajamamamamamamamamamamamamamHaHaHaHaHa
HaHaHaHaHaaDajaEamatauavamaDajaEamaFalaGamamaDajaEatauavaDajaEamamaFalaGamaDajaEamatauavamaDajaEHaHaHaHaHa
HaHaHaHaHaaDasaEamamasamamaDasaEamaFalaGamamaDasaEamasamaDasaEamamaFalaGamaDasaEamamasamamaDasaEHaHaHaHaHa
HaHaHaHaHaaoaoaoaoaoaoaoaoaoaoaoaoaqalaqaoaoaoaoaoaoaoaoaoaoaoaoaoaqalaqaoaoaoaoaoaoaoaoaoaoaoaoHaHaHaHaHa
HaHaHaHaHaapapapapapapapapapapapamaoaqaoamapapapapapapapapapapapamaoaqaoamapapapapapapapapapapapHaHaHaHaHa
HaHaHaHaHaalaHalaHalaHalaHalaHapapamaoamapapaHalaHalaHalaHalaHapapamaoamapapaHalaHalaHalaHalaHalHaHaHaHaHa
HaHaHaHaHaaHalaHalaHalaHalaHalaHapapapapapaHalaHalaHalaHalaHalaHapapapapapaHalaHalaHalaHalaHalaHHaHaHaHaHa
HaHaHaHaHaalalalalalalalalalalalaHaHaHaHaHalalalalalalalalalalalaHaHaHaHaHalalalalalalalalalalalHaHaHaHaHa
HaHaHaHaHaalalalalalalalalalalalalalalalalalalalalalalalalalalalalalalalalalalalalalalalalalalalHaHaHaHaHa
HaHaHaHaHaalalalalalalalalalalalalalalalalalalalalalalalalalalalalalalalalalalalalalalalalalalalHaHaHaHaHa
HaHaHaHaHaalalalalalalalalalalalalalalalalalalalalalalalalalalalalalalalalalalalalalalalalalalalHaHaHaHaHa
HaHaHaHaHaalalalalalalalalalalalalalalalalalalalalalalalalalalalalalalalalalalalalalalalalalalalHaHaHaHaHa
HaHaHaHaHaalalalalalalalalalalalalalalalalalalalalalalalalalalalalalalalalalalalalalalalalalalalHaHaHaHaHa
HaHaHaHaHaalalalalalalalalalalalalalalalalalalalalalalalalalalalalalalalalalalalalalalalalalalalHaHaHaHaHa
HaHaHaHaHaalalalalalalalalalalalalalalalalalalalalalalalalalalalalalalalalalalalalalalalalalalalHaHaHaHaHa
HaHaHaHaHaalalalalalalalalalalalalalalalalalalalalalalalalalalalalalalalalalalalalalalalalalalalHaHaHaHaHa
HaHaHaHaHaaIaIaIaIaIaJaIaIaIaIaIaIaIaJaIaIaIaIaIaIaIaJaIaIaIaIaIaIaIaJaIaIaIaIaIaIaIaJaIaIaIaIaIHaHaHaHaHa
HaHaHaHaHaaIaIaIaIaIaIaIaIaIaIaIaIaIaIaIaIaIaIaIaIaIaIaIaIaIaIaIaIaIaIaIaIaIaIaIaIaIaIaIaIaIaIaIHaHaHaHaHa
HaHaHaHaHaaIaIaIaIaIaIaIaIaIaIaIaIaIaIaIaIaIaIaIaIaIaIaIaIaIaIaIaIaIaIaIaIaIaIaIaIaIaIaIaIaIaIaIHaHaHaHaHa
HaHaHaHaHaaIaIaIaIaIaIaIaIaIaIaIaIaIaIaIaIaIaIaIaIaIaIaIaIaIaIaIaIaIaIaIaIaIaIaIaIaIaIaIaIaIaIaIHaHaHaHaHa
HaHaHaHaHaaIaIaIaIaIaIaIaIaIaIaIaIaIaIaIaIaIaIaIaIaIaIaIaIaIaIaIaIaIaIaIaIaIaIaIaIaIaIaIaIaIaIaIHaHaHaHaHa
HaHaHaHaHaaIaIaIaIaIaIaIaIaIaIaIaIaIaIaIaIaIaIaIaIaIaIaIaIaIaIaIaIaIaIaIaIaIaIaIaIaIaIaIaIaIaIaIHaHaHaHaHa
HaHaHaHaHaaIaIaIaIaIaIaIaIaIaIaIaIaIaIaIaIaIaIaIaIaIaIaIaIaIaIaIaIaIaIaIaIaIaIaIaIaIaIaIaIaIaIaIHaHaHaHaHa
HaHaHaHaHaaIaIaIaIaIaIaIaIaIaIaIaIaIaIaIaIaIaIaIaIaIaIaIaIaIaIaIaIaIaIaIaIaIaIaIaIaIaIaIaIaIaIaIHaHaHaHaHa
HaHaHaHaHaaKaKaKaKaKaKaKaKaKaKaKaKaKaIaKaKaKaKaKaKaKaKaKaKaKaKaKaKaKaIaKaKaKaKaKaKaKaKaKaKaKaKaKHaHaHaHaHa
HaHaHaHaHaamamamamamamamamamamamamamaLamamamamamamamamamamamamamamamaLamamamamamamamamamamamamamHaHaHaHaHa
HaHaHaHaHaamamataMavamamamataMavamamaLamamataMavamataNavamataMavamamaLamamataMavamamamataMavamamHaHaHaHaHa
HaHaHaHaHaamamaDaLaEamamamaDaLaEamamaLamamaDaLaEamaDaLaEamaDaLaEamamaLamamaDaLaEamamamaDaLaEamamHaHaHaHaHa
HaHaHaHaHaamamaDaLaEamamamaDaLaEamamaLamamaDaLaEamaDaLaEamaDaLaEamamaLamamaDaLaEamamamaDaLaEamamHaHaHaHaHa
HaHaHaHaHaamamamamamamamamamamamamamaLamamamamamamamamamamamamamamamaLamamamamamamamamamamamamamHaHaHaHaHa
HaHaHaHaHaaIaIaIaIaIaIaIaIaIaIaIaIaIaIaIaIaIaIaIaIaIaIaIaIaIaIaIaIaIaIaIaIaIaIaIaIaIaIaIaIaIaIaIHaHaHaHaHa
HaHaHaHaHaaIaIaIaIaIaOaPaQaIaIaIaIaIaIaIaIaIaIaIaIaIaIaIaIaIaIaIaIaIaIaIaIaIaIaIaOaRaQaIaIaIaIaIHaHaHaHaHa
HaHaHaHaHaaIaIaIaIaIaLaSababaIaIaIaIaIaIaIaIaIaIaIaIaIaIaIaIaIaIaIaIaIaIaIaIaIababaTaLaIaIaIaIaIHaHaHaHaHa
HaHaHaHaHaaIaIaIaIaIaLaSababaIaIaIaIaIaIaIaIaIaIaIaIaIaIaIaIaIaIaIaIaIaIaIaIaIababaTaLaIaIaIaIaIHaHaHaHaHa
HaHaHaHaHaaIaIaIaIaIaIaIaIaIaIaIaIaIaIaIaIaIaIaIaIaIaIaIaIaIaIaIaIaIaIaIaIaIaIaIaIaIaIaIaIaIaIaIHaHaHaHaHa
HaHaHaHaHaaIaIaIaIaIaIaIaIaIaIaIaIaIaIaIaIaIaIaIaIaIaIaIaIaIaIaIaIaIaIaIaIaIaIaIaIaIaIaIaIaIaIaIHaHaHaHaHa
HaHaHaHaHaaIaIaIaIaIaIaIaIaIaIaIaIaIaIaIaIaIaIaIaIaIaIaIaIaIaIaIaIaIaIaIaIaIaIaIaIaIaIaIaIaIaIaIHaHaHaHaHa
HaHaHaHaHaaIaIaIaIaIaIaIaIaIaIaIaIaIaIaIaIaIaIaOaUaQaIaOaUaQaIaIaIaIaIaIaIaIaIaIaIaIaIaIaIaIaIaIHaHaHaHaHa
HaHaHaHaHaaIaIaIaIaIaIaIaIaIaIaIaIaIaIaIaIaIaIaIaIaLaLaLaIaIaIaIaIaIaIaIaIaIaIaIaIaIaIaIaIaIaIaIHaHaHaHaHa
HaHaHaHaHaaIaIaIaIaIaIaIaIaIaIaIaIaIaIaIaIaIaIaIaIaKaKaKaIaIaIaIaIaIaIaIaIaIaIaIaIaIaIaIaIaIaIaIHaHaHaHaHa
HaHaHaHaHaaIaIaIaIaIaIaIaIaIaIaIaIaIaIaIaIaIaIaIaIabababaIaIaIaIaIaIaIaIaIaIaIaIaIaIaIaIaIaIaIaIHaHaHaHaHa
HaHaHaHaHaaIaIaIaIaIaIaIaIaIaIaIaIaIaIaIaIaIaIaIaIabababaIaIaIaIaIaIaIaIaIaIaIaIaIaIaIaIaIaIaIaIHaHaHaHaHa
HaHaHaHaHaaIaIaIaIaIaIaIaIaIaIaIaIaIaIaIaIaIaIaIaIaIaIaIaIaIaIaIaIaIaIaIaIaIaIaIaIaIaIaIaIaIaIaIHaHaHaHaHa
HaHaHaHaHaaIaIaIaIaIaIaIaIaIaIaIaIaIaIaIaIaIaIaIaIaIaIaIaIaIaIaIaIaIaIaIaIaIaIaIaIaIaIaIaIaIaIaIHaHaHaHaHa
HaHaHaHaHaHaHaHaHaHaHaHaHaHaHaHaHaHaHaHaHaHaHaHaHaHaHaHaHaHaHaHaHaHaHaHaHaHaHaHaHaHaHaHaHaHaHaHaHaHaHaHaHa
HaHaHaHaHaHaHaHaHaHaHaHaHaHaHaHaHaHaHaHaHaHaHaHaHaHaHaHaHaHaHaHaHaHaHaHaHaHaHaHaHaHaHaHaHaHaHaHaHaHaHaHaHa
HaHaHaHaHaHaHaHaHaHaHaHaHaHaHaHaHaHaHaHaHaHaHaHaHaHaHaHaHaHaHaHaHaHaHaHaHaHaHaHaHaHaHaHaHaHaHaHaHaHaHaHaHa
HaHaHaHaHaHaHaHaHaHaHaHaHaHaHaHaHaHaHaHaHaHaHaHaHaHaHaHaHaHaHaHaHaHaHaHaHaHaHaHaHaHaHaHaHaHaHaHaHaHaHaHaHa
HaHaHaHaHaHaHaHaHaHaHaHaHaHaHaHaHaHaHaHaHaHaHaHaHaHaHaHaHaHaHaHaHaHaHaHaHaHaHaHaHaHaHaHaHaHaHaHaHaHaHaHaHa
HaHaHaHaHaHaHaHaHaHaHaHaHaHaHaHaHaHaHaHaHaHaHaHaHaHaHaHaHaHaHaHaHaHaHaHaHaHaHaHaHaHaHaHaHaHaHaHaHaHaHaHaHa
HaHaHaHaHaHaHaHaHaHaHaHaHaHaHaHaHaHaHaHaHaHaHaHaHaHaHaHaHaHaHaHaHaHaHaHaHaHaHaHaHaHaHaHaHaHaHaHaHaHaHaHaHa
HaHaHaHaHaHaHaHaHaHaHaHaHaHaHaHaHaHaHaHaHaHaHaHaHaHaHaHaHaHaHaHaHaHaHaHaHaHaHaHaHaHaHaHaHaHaHaHaHaHaHaHaHa
HaHaHaHaHaHaHaHaHaHaHaHaHaHaHaHaHaHaHaHaHaHaHaHaHaHaHaHaHaHaHaHaHaHaHaHaHaHaHaHaHaHaHaHaHaHaHaHaHaHaHaHaHa
HaHaHaHaHaHaHaHaHaHaHaHaHaHaHaHaHaHaHaHaHaHaHaHaHaHaHaHaHaHaHaHaHaHaHaHaHaHaHaHaHaHaHaHaHaHaHaHaHaHaHaHaHa
HaHaHaHaHaHaHaHaHaHaHaHaHaHaHaHaHaHaHaHaHaHaHaHaHaHaHaHaHaHaHaHaHaHaHaHaHaHaHaHaHaHaHaHaHaHaHaHaHaHaHaHaHa
HaHaHaHaHaHaHaHaHaHaHaHaHaHaHaHaHaHaHaHaHaHaHaHaHaHaHaHaHaHaHaHaHaHaHaHaHaHaHaHaHaHaHaHaHaHaHaHaHaHaHaHaHa
HaHaHaHaHaHaHaHaHaHaHaHaHaHaHaHaHaHaHaHaHaHaHaHaHaHaHaHaHaHaHaHaHaHaHaHaHaHaHaHaHaHaHaHaHaHaHaHaHaHaHaHaHa
HaHaHaHaHaHaHaHaHaHaHaHaHaHaHaHaHaHaHaHaHaHaHaHaHaHaHaHaHaHaHaHaHaHaHaHaHaHaHaHaHaHaHaHaHaHaHaHaHaHaHaHaHa
HaHaHaHaHaHaHaHaHaHaHaHaHaHaHaHaHaHaHaHaHaHaHaHaHaHaHaHaHaHaHaHaHaHaHaHaHaHaHaHaHaHaHaHaHaHaHaHaHaHaHaHaHa
HaHaHaHaHaHaHaHaHaHaHaHaHaHaHaHaHaHaHaHaHaHaHaHaHaHaHaHaHaHaHaHaHaHaHaHaHaHaHaHaHaHaHaHaHaHaHaHaHaHaHaHaHa
HaHaHaHaHaHaHaHaHaHaHaHaHaHaHaHaHaHaHaHaHaHaHaHaHaHaHaHaHaHaHaHaHaHaHaHaHaHaHaHaHaHaHaHaHaHaHaHaHaHaHaHaHa
afHaHaHaHaHaHaHaHaHaHaHaHaHaHaHaHaHaHaHaHaHaHaHaHaHaHaHaHaHaHaHaHaHaHaHaHaHaHaHaHaHaHaHaHaHaHaHaHaHaHaHaHa
"}
