"a" = (/turf/simulated/floor/grass,/area/wilderness)
"b" = (/obj/item/torch/self_lit,/turf/simulated/floor/grass,/area/wilderness)
"c" = (/obj/effect/landmark/start/assistant,/turf/simulated/floor/grass,/area/wilderness)
"d" = (/turf/simulated/open,/area/wilderness)
"e" = (/obj/effect/landmark{name = "JoinLate"},/turf/simulated/floor/grass,/area/wilderness)
"f" = (/turf/simulated/wall/wood,/area/wilderness)
"g" = (/obj/structure/torchwall{icon_state = "torchwall0"; dir = 1},/turf/simulated/floor/grass,/area/wilderness)
"h" = (/obj/structure/toilet,/turf/simulated/floor/wood,/area/wilderness)
"i" = (/obj/structure/table/steel,/obj/item/gun/projectile/makarov,/turf/simulated/floor/grass,/area/wilderness)
"j" = (/obj/structure/sink{icon_state = "sink"; dir = 8},/turf/simulated/floor/wood,/area/wilderness)
"k" = (/obj/structure/torchwall{icon_state = "torchwall0"; dir = 1},/turf/simulated/floor/wood,/area/wilderness)
"l" = (/turf/simulated/floor/wood,/area/wilderness)
"m" = (/obj/structure/torchwall{dir = 8; icon_state = "torchwall0"},/turf/simulated/floor/grass,/area/wilderness)
"n" = (/mob/living/carbon/human/blank,/turf/simulated/floor/grass,/area/wilderness)
"o" = (/obj/effect/landmark/start,/turf/simulated/floor/grass,/area/wilderness)
"p" = (/obj/structure/table/steel,/obj/item/gun/projectile/automatic/m22,/obj/structure/torchwall{icon_state = "torchwall0"; dir = 4},/turf/simulated/floor/grass,/area/wilderness)
"q" = (/obj/structure/torchwall,/turf/simulated/wall/wood,/area/wilderness)
"r" = (/obj/item/shovel,/obj/structure/torchwall{icon_state = "torchwall0"; dir = 4},/turf/simulated/floor/grass,/area/wilderness)
"s" = (/obj/effect/landmark/map_data{height = 2},/turf/simulated/floor/grass,/area/wilderness)
"t" = (/obj/item/reciever,/obj/item/stock,/obj/item/pipe,/obj/item/cylinder/one_slot,/obj/item/cylinder/four_slot,/obj/item/screwdriver,/turf/simulated/floor/grass,/area/wilderness)
"u" = (/obj/item/cylinder/four_slot,/turf/simulated/floor/grass,/area/wilderness)

(1,1,1) = {"
aaaaaaaaaaaaaaaaaaaaaaaaaaaaaaaaaaaaaaaaaaaaaaaaaa
aaaaaaaaaaaaaaaaaaaaaaaaaaaaaaaaaaaaaaaaaaaaaaaaaa
aaaaaaaaaaaaaaaaaaaaaaaaaaaaaaaaaaaaaaaaaaaaaaaaaa
aaaaaaaaaaaaaaaaaaaaaaaaaaaaaaaaaaaaaaaaaaaaaaaaaa
aaaaaaaaaaaaaaaaaaaaaaaaaaaaaaaaaaaaaaaaaaaaaaaaaa
aaaaaaaaaaaaaaaaaaaaaaaaaaaaaaaaaaaaaaaaaaaaaaaaaa
aaaaaaaaaaaaaaaaaaaaaaaaaaaaaaaaaaaaaaaaaaaaaaaaaa
aaaaaaaaaaaaaaaaaaaaaaaaaaaaaaaaaaaaaaaaaaaaaaaaaa
aaaaaaaaaaaaaaaaaaaaaaaaaaaaaaaaaaaaaaaaaaaaaaaaaa
aaaaaaaaaaaaaaaaaaaaaaaaaaaaaaaaaaaaaaaaaaaaaaaaaa
aaaaaaaaaaaaaaaaaaaaaaaaaaaaaaaaaaaaaaaaaaaaaaaaaa
aaaaaaaaaaaaaaaaaaaaaaaaaaaaaaaaaaaaaaaaaaaaaaaaaa
aaaaaaaaaaaaaaaaaaaaaaaaaaaaaaaaaaaaaaaaaaaaaaaaaa
aaaaaaaaaaaaaaaaaaaaaaaaaaaaaaaaaaaaaaaaaaaaaaaaaa
aaaaaaaaaaaaaaaaaaaaaaaaaaaaaaaaaaaaaaaaaaaaaaaaaa
aaaaaaaaaaaaaaaaaaaaaaaaaaaaaaaaaaaaaaaaaaaaaaaaaa
aaaaaaaaaaaaaaaaaaaaaaaaaaaaaaaaaaaaaaaaaaaaaaaaaa
aaaaaaaaaaaaaaaaaaaaaaaaaaaaaaaaaaaaaaaaaaaaaaaaaa
aaaaaaaaaaaaaaaaaaaaaaaaaaaaaaaaaaaaaaaaaaaaaaaaaa
aaaaaaaaaaaaaaaaaaabaacaaaaaaaaaaaaaaaaaaaaaaaaaaa
aaaaaaaaaaaaaaaagddaaaeaaaaaaaaaaaaaaaaaaaaaaaaaaa
aaaaaaaaaaaaaamffffpaaaabaaaaaaaaaaaaaaaaaaaaaaaaa
aaaaaaaaaaaaaaaffhfitaaaaaaaaaaaaaaaaaaaaaaaaaaaaa
aaaaaaaaaaaaaaafjklauaaaaaaaaaaaaaaaaaaaaaaaaaaaaa
aaaaaaaaaaaaaamfffqrbaaaaaaaaaaaaaaaaaaaaaaaaaaaaa
aaaaaaaaaaaaaaannnnaaaoaaaabaaaaaaaaaaaaaaaaaaaaaa
aaaaaaaaaaaaaaaaaaaaaaaaaaaaaaaaaaaaaaaaaaaaaaaaaa
aaaaaaaaaaaaaaaaaaaaaaaaaaaaaaaaaaaaaaaaaaaaaaaaaa
aaaaaaaaaaaaaaaaaaaaaaaaaaaaaaaaaaaaaaaaaaaaaaaaaa
aaaaaaaaaaaaaaaaaaaaaaaaaaaaaaaaaaaaaaaaaaaaaaaaaa
aaaaaaaaaaaaaaaaaaaaaaaaaaaaaaaaaaaaaaaaaaaaaaaaaa
aaaaaaaaaaaaaaaaaaaaaaaaaaaaaaaaaaaaaaaaaaaaaaaaaa
aaaaaaaaaaaaaaaaaaaaaaaaaaaaaaaaaaaaaaaaaaaaaaaaaa
aaaaaaaaaaaaaaaaaaaaaaaaaaaaaaaaaaaaaaaaaaaaaaaaaa
aaaaaaaaaaaaaaaaaaaaaaaaaaaaaaaaaaaaaaaaaaaaaaaaaa
aaaaaaaaaaaaaaaaaaaaaaaaaaaaaaaaaaaaaaaaaaaaaaaaaa
aaaaaaaaaaaaaaaaaaaaaaaaaaaaaaaaaaaaaaaaaaaaaaaaaa
aaaaaaaaaaaaaaaaaaaaaaaaaaaaaaaaaaaaaaaaaaaaaaaaaa
aaaaaaaaaaaaaaaaaaaaaaaaaaaaaaaaaaaaaaaaaaaaaaaaaa
aaaaaaaaaaaaaaaaaaaaaaaaaaaaaaaaaaaaaaaaaaaaaaaaaa
aaaaaaaaaaaaaaaaaaaaaaaaaaaaaaaaaaaaaaaaaaaaaaaaaa
aaaaaaaaaaaaaaaaaaaaaaaaaaaaaaaaaaaaaaaaaaaaaaaaaa
aaaaaaaaaaaaaaaaaaaaaaaaaaaaaaaaaaaaaaaaaaaaaaaaaa
aaaaaaaaaaaaaaaaaaaaaaaaaaaaaaaaaaaaaaaaaaaaaaaaaa
aaaaaaaaaaaaaaaaaaaaaaaaaaaaaaaaaaaaaaaaaaaaaaaaaa
aaaaaaaaaaaaaaaaaaaaaaaaaaaaaaaaaaaaaaaaaaaaaaaaaa
aaaaaaaaaaaaaaaaaaaaaaaaaaaaaaaaaaaaaaaaaaaaaaaaaa
aaaaaaaaaaaaaaaaaaaaaaaaaaaaaaaaaaaaaaaaaaaaaaaaaa
aaaaaaaaaaaaaaaaaaaaaaaaaaaaaaaaaaaaaaaaaaaaaaaaaa
saaaaaaaaaaaaaaaaaaaaaaaaaaaaaaaaaaaaaaaaaaaaaaaaa
"}
